---------------
-%%%%%%%%%%%%A-
-%-C-%-%-%-C-%-
-%CCC%%%%%CCC%-
-%-C-%-%-%-C-%-
-%%%%%%%%%%%%%-
-%-%-%-C-%-%-%-
-%%%%%CCC%%%%%-
-%-C-%-C-%-C-%-
-%%%%%%%%%%%%%-
-%-C-%-%-%-C-%-
-%CCC%%%%%CCC%-
-%-C-%-%-%-C-%-
-M%%%%%%%%%%%%-
---------------