---------------
-%%%%%%%%%%%%A-
-%-%-%-%-%-%-%-
-%%%%%%%%%%%%%-
-%-%-%-%-%-%-%-
-%%%%%%%%%%%%%-
-%-%-%-%-%-%-%-
-%%%%%%%%%%%%%-
-%-%-%-%-%-%-%-
-%%%%%%%%%%%%%-
-%-%-%-%-%-%-%-
-%%%%%%%%%%%%%-
-%-%-%-%-%-%-%-
-M%%%%%%%%%%%%-
---------------