---------------
-%%C%C%%%C%C%A-
-%-C-C-%-%-C-%-
-CCCCCC%%CCCCC-
-%-C-C-%-%-C-C-
-CCCCC%%%C%C%C-
-%-C-%-C-%-%-%-
-%%%%%CCC%%%%%-
-%-C-%-C-%-C-%-
-C%C%C%%%CCCCC-
-%-C-%-%-C-C-%-
-CCCCC%%CCCCCC-
-%-C-%-%-C-C-%-
-M%C%C%%%C%C%%-
---------------