---------------
-%%%%%%%%%%%%%-
-%-%-%-%-%-%-%-
-%%%%%%%%%%%%%-
-%-%-%-%-%-%-%-
-%%%%%%%%%%%%%-
-%-%-%-%-%-%-%-
-%%%%%M%%%%%%%-
-%-%-%-%-%-%-%-
-%%%%%%%%%%%%%-
-%-%-%-%-%-%-%-
-%%%%%%%%%%%%%-
-%-%-%-%-%-%-%-
-%%%%%%%%%%%%%-
---------------